
NO textures/capri.png
WE textures/wolf.png
EA textures/spider.png


SO   textures/wick.png

F 153, 204, 255                
C 85,  85,  85
11111111111111
10001000100001
10101010101001
11001010001001
1001001010101
1010S000100001
10100001001001
10101101000101
10000001010001
10111101000101
10000101011001
10100101000001
10100101010001
10100101001001
10100000010001
11111111111111