
NO textures/capri.png
WE textures/wolf.png
EA textures/spider.png


SO   textures/wick.png

F 153, 204, 255                
C 85,  85,  85

11111
10001
10101
11N01
10011
10101
11111