      
C 85,  85,  85



EA textures/spider.png

NO textures/capri.png
WE textures/wolf.png
SO   textures/wick.png



1111101111
1010101001
1000000001
1010101001
1000000001
1010101001
1000000001
1010001001111111
1000000000000001
1010001001000001
10000N0001000001
1111111111111111