

NO textures/capri.png
WE textures/wolf.png
EA textures/spider.png


SO   textures/wick.png

F 153, 204, 255                
C 85,  85,  85
1111111111
1000000001
1000000001
1000000001
1000000001
1000000001
10000001d100
10000011d1100
100000dN0001
100000100110
1000000001
1111111111