
NO textures/capri.png
WE textures/wolf.png
EA textures/spider.png


SO   textures/wick.png

F 153, 204, 255                
C 85,  85,  85

1111111
1000001
101d101
10d0d01
101d101
1100011
101d101
10dNd01
1111111