
F 153, 204, 255                
C 85,  85,  85



EA textures/spider.png

NO textures/capri.png
WE textures/wolf.png
SO   textures/wick.png

11111111111111
100000S000d001
1d1d1d1d1d1001
10d0d0d0d01001
1d1d101d1d1001
10d0d0d0d01001
101010101d1001
10d0d0d0d0d001
10101010101001
10d0d0d0d0d001
1d101010101001
10d0d0d0d0d001
1d1010101d1001
10d0d0d0d00001
1d1d1d1d100001
11111111111111